1111111111111
10010000000C1
11C0011111001
1000110P000E1
1111111111111