1111111111111
10010000000C1
11C0011P11001
100011E000001
1111111111111